........................*
........................*
........................*
........................*
.............############
.............############
............#############
.........################
.......##################
0000000##################
